1111111111111
10000C0000001
1000000000001
1001100000001
100110000C001
100000000E001
10000P0000001
100C000111001
1C000000110C1
1111111111111


//map[0][X] = 1
//map[X][0] = 1
//map[X][lenght] = 1
//map[rows][X] = 1