1111111111111
1000000010001
1000P10010E01
1001110111001
1C000000110C1
1111111111111