11111111111
100PEC00001
11101000111
10000000001
10000000001
10000000001
11100000111
10000000001
11111111111