11111111111
100PCE00001
11111111111
10000000001
10000000001
10000000001
11100000111
10000000001
11111111111